1 1 1 1 1 1 1 1 1 1 1 1 1 1 1 1 1 1 1 1 1 1 1 1 1 1 1 1 1 1 1 1
1 1 0 1 0 1 0 1 1 1 1 0 1 1 1 1 1 0 0 1 1 0 1 0 1 0 1 1 1 1 0 1
0 1 1 0 1 1 0 0 1 0 0 1 1 1 1 0 1 1 1 0 1 1 0 1 1 0 0 1 0 0 1 1
1 1 1 1 1 2 2 2 2 2 2 2 1 1 1 0 0 1 1 1 1 1 1 1 2 2 2 2 2 2 2 1 
1 1 1 1 1 2 4 4 2 4 4 2 0 5 5 5 5 5 0 1 1 1 1 1 2 4 4 2 4 4 2 0
0 1 1 0 1 2 2 2 2 2 2 2 0 5 5 4 5 5 1 0 1 1 0 1 2 2 2 2 2 2 2 0
1 1 1 1 1 2 4 4 2 4 4 2 1 5 5 4 5 5 0 1 1 1 1 1 2 4 4 2 4 4 2 1
1 2 2 2 1 2 2 2 2 2 2 2 1 5 5 5 5 5 1 1 2 2 2 1 2 2 2 2 2 2 2 1
1 2 10 2 1 2 2 2 7 2 2 2 1 5 5 7 5 5 1 1 2 10 2 1 2 2 2 7 2 2 2 1
1 2 9 2 3 2 2 2 6 2 2 2 11 5 5 6 5 5 1 1 2 9 2 3 2 2 2 6 2 2 2 11
8 8 8 8 8 8 8 8 8 8 8 8 8 8 8 8 8 8 8 8 8 8 8 8 8 8 8 8 8 8 8 8
8 8 8 8 8 8 8 8 8 8 8 8 8 8 8 8 8 8 8 8 8 8 8 8 8 8 8 8 8 8 8 8
8 8 8 8 8 8 8 8 8 8 8 8 8 8 8 8 8 8 8 8 8 8 8 8 8 8 8 8 8 8 8 8
8 8 8 8 8 8 8 8 8 8 8 8 8 8 8 8 8 8 8 8 8 8 8 8 8 8 8 8 8 8 8 8   
8 8 8 8 8 8 8 8 8 8 8 8 8 8 8 8 8 8 8 8 8 8 8 8 8 8 8 8 8 8 8 8 
